111111111111111111111111111111111111111111
100000000000000000000000000000000000001111
111111111111111111111111111111111111111111
111000000000000000000000000000000000000001
111111111111111111111111111111111111111111