11111111111111111111111111111111111111111111
10000000001100000000000000000000110000000001
10000000001100000000011000000000110000000001
10000000000000000000011000000000000000000000
11111111111111111111111111111111111111111111