C 8, 200, 200
F 255, 0, 0


EA ./path_vers_texture_ea
SO ./path_vers_texture_so
WE ./path_vers_texture_we
NO ./path_vers_texture_no




bonjour


                   11111111111111111111111111111111111111111111
                   10000000001100000000000000000000110000000001
111111111111111110000011000000000110000000011111111111111111
10000000000000000000011000000000000000000001
                           11111111111111111111111111111111111111111111
