
EA ./path_vers_texture_ea
SO ./path_vers_texture_so
WE ./path_vers_texture_we
NO ./path_vers_texture_no
F 255, 0, 0
C 0, 255, 0

          1111111111111111111111111    11111111111111111111
          11111110111110000000000011111000000011111111111  
111111111111111110000011000000000110000000011111111111111111
10000000000000000000011000000000000000000001
1111111111111111111111111111111111111111111
