C 125, 0, 21
F 21, 21, 119

EA ./img/ea.xpm
SO ./img/so.xpm
NO ./img/no.xpm
WE ./img/we.xpm

11111111
10100001
10100001
10100001
10000N01
10000101
10000001
11111111