C 8, 200, 200
F 255, 0, 0

EA ./img/ea.xpm
SO ./img/so.xpm
NO ./img/no.xpm
WE ./img/we.xpm

          1111111111111111111111111    11111111111111111111
111111111110000000000000000000011111111111111
1111111111111111100N0011000000000110000000011111111111111111
1000000000000000000001100000000000000000000111
1111111111111111111111111111111111111111111111
