C 0, 200, 200
F 255, 0, 0

EA ./img/ea.xpm
SO ./img/so.xpm
NO ./img/no.xpm
WE ./img/we.xpm

11111111
10010001
10010001
10010001
10000001
10000001
10000001
11111111