C 0, 200, 200
F 255, 0, 0

EA ./img/ea.xpm
SO ./img/so.xpm
NO ./img/no.xpm
WE ./img/we.xpm

11111111
10100001
1010000111
1010W00001
1000000001
1000010111
10000001
11111111