

11111111111111111111111111111111111111111111
100000000011000000000000000000001100000000011111111111
100000000011000D0000011000000000110000000001
10000000000000000000011000000000000000000001
11111111111111111111111111111111111111111111