NO  ./xxxxxxxxxxxxxxxxxxxx
SO  ./xxxxxxxxxxxxxxxxxxxxxxx
WE  ./xxxxxxxxxxxxxxxxxxxxx
EA  ./xxxxxxxxxxxxxxxxxxxxxxx

F   XXXXXX XXXXXXXXXX
C   XXXXXXXXXX XXXXXXXX

11111111111111111111111111111111111111111111
10000000001100000000000000000000110000000001
111111111111111110000011000000000110000000011111111111111111
10000000000000000000011000000000000000000001
11111111111111111111111111111111111111111111