
EA ./img/ea.xpm
SO ./img/so.xpm
WE ./img/we.xpm
NO ./img/no.xpm
F 255, 0, 0
C 0, 255, 0

          1111111111111111111111111    11111111111111111111
          11111110111110000000000011111000000011111111111  
11111111111111111000001100000000110000000011111111111111111
1S000000000000000000011000000000000000000001
1111111111111111111111111111111111111111111
