C 8, 200, 200
F 255, 0, 0

EA ./img/ea.xpm
SO ./img/so.xpm
WE ./img/we.xpm
NO ./img/no.xpm

          1111111111111111111111111    11111111111111111111
111111111110000000000000000000011111111111
111111111111111110000011000000000110000000011111111111111111
10000000000000000000011000000000000000000001
1111111111111111111111111111111111111111111